.........................
..o.....................o
..o....................*o
..o.o.................o*o
..o.o................*o*o
..o.o.o.............o*o*o
..o.o.o............*o*o*o
..o.o.o.o.........o*o*o*o
..o.o.o.o........*o*o*o*o
..o.o.o.o.o.....o*o*o*o*o
..o.o.o.o.o....*o*o*o*o*o
..o.o.o.o.o.o.o*o*o*o*o*o
..o.o.o.o.o.o*o*o*o*o*o*o
..o.o.o.o.o.o.o*o*o*o*o*o
..o.o.o.o.o....*o*o*o*o*o
..o.o.o.o.o.....o*o*o*o*o
..o.o.o.o........*o*o*o*o
..o.o.o.o.........o*o*o*o
..o.o.o............*o*o*o
..o.o.o.............o*o*o
..o.o................*o*o
..o.o.................o*o
..o....................*o
..o.....................o
u........................


points 1000
maxsize 13
